222202221222222
222202221222222
222202221112222
222202111111222
222202220222222
222202220221111
222202220222211
222202220221111
222211111122222
222222220111111
222222220111111
222222222111111