222222222222222
222000020000222
222222222222222
000022000220000
222222222222222
222000020000222
222222222222222
220022000220022
222222222222222
002000202000200
222222222222222
222222222222222