222202222222222
222202222222222
222202222222222
222202222222222
222202220222222
222202220222222
222202220222222
222202220222222
222222220222222
222222220222222
222222220222222
222222222222222